GFXcanvas1	KEYWORD1
GFXcanvas8	KEYWORD1
GFXcanvas16	KEYWORD1
GFXiCanvas	KEYWORD1
Adafruit_GFX	KEYWORD1

drawPixel	KEYWORD2
writePixel	KEYWORD2
writeFillRect	KEYWORD2
writeLine	KEYWORD2
writeFastVLine	KEYWORD2
writeFastHLine	KEYWORD2
setRotation	KEYWORD2
invertDisplay	KEYWORD2
display	KEYWORD2
drawFastVLine	KEYWORD2
drawFastHLine	KEYWORD2
fillRect	KEYWORD2
fillScreen	KEYWORD2
clearDisplay	KEYWORD2
drawLine	KEYWORD2
drawRect	KEYWORD2
color565	KEYWORD2

drawCircle	KEYWORD2
fillCircle	KEYWORD2
drawTriangle	KEYWORD2
fillTriangle	KEYWORD2
drawRoundRect	KEYWORD2
fillRoundRect	KEYWORD2
drawBitmap	KEYWORD2
drawXBitmap	KEYWORD2
drawGrayscaleBitmap	KEYWORD2
drawRGBBitmap	KEYWORD2
drawChar	KEYWORD2
setCursor	KEYWORD2
setTextColor	KEYWORD2
setTextSize	KEYWORD2
setTextWrap	KEYWORD2
cp437	KEYWORD2
setFont	KEYWORD2
getTextBounds	KEYWORD2

height	KEYWORD2
width	KEYWORD2
getRotation	KEYWORD2
getCursorX	KEYWORD2
getCursorY	KEYWORD2

ERR_NOMEM	KEYWORD3
ERR_OUTOFRANGE	KEYWORD3
